[Animal:0]
Лев = Царь зверей
Тигр = Полосатый хищник
Слон = Самое крупное наземное животное
Жираф = Самое высокое животное
Зебра = Полосатая лошадь
[Animal:1]
Бородавочник = Африканское млекопитающее семейства свиней, отличающееся наличием бородавок на морде.
Толстолобик = Вид пресноводных рыб семейства карповых, известный своими толстыми губами.
Выхухоль = Редкое полуводное млекопитающее, обитающее в реках и озерах Европы.
Вуалехвост = Тропическая рыба с длинными плавниками, которые напоминают вуаль.
Дромедар = Одногорбый верблюд, обитающий в Северной Африке и Азии.
[Town:0]
Казань = Столица Татарстана, известна своим Кремлем и мечетью Кул-Шариф.
Самара = Город на Волге, центр авиационной промышленности, известен космодромом Байконур.
Омск = Город в Сибири, центр нефтехимической промышленности, известен своим музеем "Омская крепость".
Пермь = Город на Урале, известен своими природными достопримечательностями, такими как Пермские столбы.
Уфа = Столица Башкортостана, известна своей нефтяной промышленностью, музеем археологии и этнографии.
[Town:1]
Новосибирск = Крупнейший город Сибири, известен своим зоопарком и Академгородком.
Екатеринбург = Центр Урала, известен своей историей, связанной с династией Романовых, и "Ельцин-центром".
Челябинск = Промышленный центр Южного Урала, известен своим Челябинским метеоритом.
Красноярск = Крупнейший город Красноярского края, известен своими природными красотами, такими как заповедник "Столбы".
Волгоград = Город на Волге, известен своей историей, связанной с битвой за Сталинград, и Мамаевым курганом.
[Person:0]
Ганди = Индийский лидер движения за независимость
Есенин = Русский поэт, известный своими лирическими стихами о природе
Сталин = Принял страну с сохой а оставил с атомной бомбой
Пушкин = Русский поэт, писатель, драматург
Толстой = Русский писатель, автор "Войны и мира"
[Person:1]
Линкольн = Президент США, освободивший рабов
Рузвельт = Президент США во время Второй мировой войны
Черчилль = Премьер-министр Великобритании во время Второй мировой войны
Достоевский = Русский писатель, автор "Преступления и наказания"
Чайковский = Русский композитор, автор "Лебединого озера"
